1 1 1 1 1
1 7 4 8 1
1 4 4 4 1
1 8 4 7 1
1 1 1 1 1
