11 11 11 11 11
11 15 15 15 11
11 15 21 15 11
11 15 15 15 11
11 11 11 11 11
