1 1 0 0 0
0 4 1 4 0
0 4 8 4 7
0 4 1 4 1
0 0 0 0 1
