1 1 1 1 1
1 4 3 4 1
1 4 12 4 1
1 4 3 4 1
1 1 1 1 1
