1, 0, 0, 0, 0
0, 0, 0, 0, 0
3, 0, 5, 0, 0
0, 0, 0, 4, 7
0, 0, 0, 4, 7