06 05
-3 -3 -3 -3 -4 -3
-3 -1 -4 -3 -3 -4
-3 -3 -3 -4 -3 -3
-3 -3 -3 -3 -3 -2
-3 -2 -3 -3 -3 -3