10 10
-3 -3 -4 -3 -3 -3 -4 -3
-4 -3 -3 -4 -4 -3 -3 -4
-3 -2 -3 -3 -3 -4 -3 -3
-3 -3 -3 -3 -3 -3 -2 -3
-3 -3 -4 -3 -3 -3 -4 -3
-4 -3 -3 -4 -4 -3 -3 -4
-3 -4 -3 -3 -3 -4 -3 -3
-3 -3 -3 -3 -3 -3 -3 -3
-3 -4 -1 -3 -3 -4 -3 -3
-3 -3 -3 -3 -2 -3 -3 -3