1 1 1 1 1
1 17 2 1 1
1 7 12 2 1
1 7 6 17 1
1 1 1 1 1
