1 1 0 0 0
0 4 4 4 0
0 4 9 1 1
0 4 1 1 1
0 0 0 0 1
