2 2 2 2 2
3 3 8 8 7
1 1 9 1 4
1 1 4 4 4
1 1 4 4 4
