1 11 11 1 1
11 11 2 6 1
1 11 12 2 1
11 11 11 11 1
11 11 11 1 1
