1 1 1 1 1
1 12 8 8 1
1 12 12 8 1
1 20 21 21 1
1 1 1 1 1
