1 1 1 1 6
1 4 4 4 1
1 7 4 2 1
1 7 4 4 1
1 1 1 1 1
