1 1 1 1 1
1 4 3 4 1
1 3 12 3 1
1 4 3 4 1
1 1 1 1 1
