4 4 0 0 0
0 4 1 4 0
0 4 1 4 7
0 4 1 4 4
0 0 0 0 4
