11 11 11 11 11
11 7 22 23 11
11 7 7 21 11
11 8 8 7 11
11 11 11 11 11
