4 4 4 4 4
1 3 9 3 1
1 3 1 3 1
1 3 1 3 1
4 4 4 4 4
