1 3 11 1 1
1 11 11 2 1
11 11 12 11 11
1 2 11 11 1
1 1 11 3 1
