1 1 1 1 1
1 1 14 18 1
1 1 9 1 1
1 1 1 1 1
1 1 1 1 1
