06 05
-3 -3 -4 -3 -3 -2
-4 -3 -3 -4 -3 -3
-3 -4 -3 -3 -3 -3
-1 -3 -3 -2 -3 -3
-3 -3 -4 -3 -3 -3