06 06
-3 -3 -3 -3 -3 -3
-3 -3 -4 -3 -3 -3
-4 -3 -3 -4 -1 -3
-3 -4 -3 -3 -3 -3
-2 -3 -3 -2 -3 -3
-3 -3 -3 -3 -3 -3