06 05
-2 -3 -3 -4 -3
-3 -4 -3 -1 -4
-3 -3 -4 -3 -3
-3 -3 -3 -2 -3
-3 -3 -3 -3 -3