1 1 1 3 1
1 1 1 1 1
1 3 1 1 1
1 6 1 20 1
1 1 1 1 1
