1 1 1 11 11
1 3 11 11 1
1 11 11 1 1
11 11 3 1 1
11 1 1 1 1
