1 11 1 11 1
11 1 11 14 11
1 11 1 11 1
11 14 11 1 11
1 11 1 11 1
