1 4 1 1 3
1 4 1 3 2
1 1 2 2 2
1 3 2 7 7
3 2 2 7 7
