1 2 2 2 1
1 7 1 1 1
1 1 1 1 1
1 1 1 3 1
13 1 1 1 1
